cSHT3x	KEYWORD1
PeriodicityToMillis	KEYWORD2
begin	KEYWORD2
celsiusToRawT	KEYWORD2
end	KEYWORD2
getClockStretching	KEYWORD2
getCommand	KEYWORD2
getCrcMode	KEYWORD2
getHeater	KEYWORD2
getPeriodicMeasurement	KEYWORD2
getPeriodicMeasurementRaw	KEYWORD2
getPeriodicity	KEYWORD2
getRepeatability	KEYWORD2
getStatus	KEYWORD2
getTemperatureHumidity	KEYWORD2
getTemperatureHumidityRaw	KEYWORD2
isDebug	KEYWORD2
millisToPeriodicity	KEYWORD2
operator=	KEYWORD2
percentRHtoRaw	KEYWORD2
rawRHtoPercent	KEYWORD2
rawTtoCelsius	KEYWORD2
reset	KEYWORD2
setCrcMode	KEYWORD2
setHeater	KEYWORD2
startPeriodicMeasurement	KEYWORD2
cSHT3x::Address_t	KEYWORD1
cSHT3x::MeasurementsRaw	KEYWORD1
extract	KEYWORD2
cSHT3x::Measurements	KEYWORD1
extract	KEYWORD2
set	KEYWORD2
cSHT3x::Command	KEYWORD1
cSHT3x::ClockStretching	KEYWORD1
cSHT3x::Periodicity	KEYWORD1
cSHT3x::Repeatability	KEYWORD1
cSHT3x::Status_t	KEYWORD1
getBits	KEYWORD2
isAlert	KEYWORD2
isCommandBadCS	KEYWORD2
isCommandFailure	KEYWORD2
isHeaterOn	KEYWORD2
isRHTrackingAlert	KEYWORD2
isSystemResetDetected	KEYWORD2
isTemperatureTrackingAlert	KEYWORD2
isValid	KEYWORD2
